WWWWWWWWWWWWWWWWWWWWWWWWWWWWWWWWWWWWWWWWWWWWWWWWWWWWWWWWWWWW
W              WGGGGGGGGGGGGGGGGGGGGGGGGGGGGGW             W
W              WGGGGGGGGGGGGGGGGGGGGGGGGGGGGGW             W
W     E        WGGGGGGGGGGGGGGGGGGGGGGGGGGGGGW       E     W
W               WWGGGGGGGGGGGGGGGGGGGGGGGGGWW              W
W                 WWGGGGGGGGGGGGGGGGGGGGGWW                W
WWWWWWWWWWWWW       WWWWGGGGGGGGGGGGGWWWW       WWWWWWWWWWWW
WGGGGGGGGGGGGWW                               WWGGGGGGGGGGGW
WGGGGGGGGGGGGGWW                            WWGGGGGGGGGGGGGW
WGGGGGGGGGGGGGGGWW                        WWGGGGGGGGGGGGGGGW
WGGGGGGGGGGGGGGGGW                        WGGGGGGGGGGGGGGGGW
WGGGGGGGGGGGGGGGGW                        WGGGGGGGGGGGGGGGGW
WGGGGGGGGGGGGGGGGW                        WGGGGGGGGGGGGGGGGW
WGGGGGGGGGGGGGGGGG                        GGGGGGGGGGGGGGGGGW
WGGGGGGGGGGGGGGGGG            J           GGGGGGGGGGGGGGGGGW
WGGGGGGGGGGGGGGGGG                        GGGGGGGGGGGGGGGGGW
WGGGGGGGGGGGGGGGGG                        GGGGGGGGGGGGGGGGGW
WGGGGGGGGGGGGGGGGW                        WGGGGGGGGGGGGGGGGW
WGGGGGGGGGGGGGGGGW                        WGGGGGGGGGGGGGGGGW
WGGGGGGGGGGGGGGGGW                        WGGGGGGGGGGGGGGGGW
WGGGGGGGGGGGGGGGWW                        WWGGGGGGGGGGGGGGGW
WGGGGGGGGGGGGGWW                            WWGGGGGGGGGGGGGW
WGGGGGGGGGGGWW                                WWGGGGGGGGGGGW
WWWWWWWWWWWW        WWWWGGGGGGGGGGGGGWWWW       WWWWWWWWWWWW
W                 WWGGGGGGGGGGGGGGGGGGGGGWW                W
W               WWGGGGGGGGGGGGGGGGGGGGGGGGGWW              W
W     E        WGGGGGGGGGGGGGGGGGGGGGGGGGGGGGW       E     W
W              WGGGGGGGGGGGGGGGGGGGGGGGGGGGGGW             W
W              WGGGGGGGGGGGGGGGGGGGGGGGGGGGGGW             W
WWWWWWWWWWWWWWWWWWWWWWWWWWWWWWWWWWWWWWWWWWWWWWWWWWWWWWWWWWWW
