WWWWWWWWWWWWWWWWWWWWWWWWWWWWWWWWWWWWWWWWWWWWWWWWWWWWWWWWWWWW
W            W         GGGGGGGGGGGGGGGGGGGGGGGGGGGGGGGGGGGGW
W      E                 GGGGGGGGGGGGGGGGGGGGGGGGGGGGGGGGGGW
W            W             GGGGGGGGGGGGGGGGGGGGGGGGGGGGGGGGW
WGGGGGGGGGGGGW                GGGGGGGGGGGGGGGGGGGGGGGGGGGGGW
WGGGGGGGGGGGGW                  GGGGGGGGGGGGGGGGGGGGGGGGGGGW
WGGGGGGGGGGGGW                    GGGGGGGGGGGGGGGGGGGGGGGGGW
WGGGGGGGGGGGGW                       GGGGGGGGGGGGGGGGGGGGGGW
WGGGGGGGGGGGGW                          GGGGGGGGGGGGGGGGGGGW
WGGGGGWWWWWWWW                               GGGGGGGGGGGGGGW
W                                                GGGGGGGGGGW
W                                                   GGGGGGGW
W                                                     GGGGGW
W                                                       GGGW
WGGGGGGGGGGGGGGGGGGGGGGGGGGGGGGGGGGGGGGGGGGGGGGGGGG GGGGGGGW
WGGGGGGGGGGGGGGGGGGGGGGGGGGGGGGGGGGGGGGGGGGGGGGGGGG GGGGGGGW
WGGGGGGGGGGGGWWWWWWWWWWWWWWWWWWWWWWWWWWWWWWWWWWWWWW WWWWWWWW
WGGGGGGGGGGGG                                              W
WGGGGGGGGGGGG                                              W
WGGGGGGGGGGGG                                              W
WGGGGGGGGGGGG                             WWWWWWWWWWWWWWWWWW
WGGGGGGGGGGGGW                            WGGGGGGGGGGGG E GW
WGGGGGGGGGGGGW                            WGGGGGGGGGGGGGGGGW
WGGGGGGGGGGGGW                             GGGGGGGGGGGGGGGGW
W            W                            GGGGGGGGGGGGGGGGGW
W            WWWWWWWWWWWWWWWWWWWWWWWWWWWWWWWWWWWWWWWWWWWWWWW
W                       GGGGGGGGGGGGGGGGGGGG               W
W                       GGGGGGGGGGGGGGGGGGGG       J       W
W                       GGGGGGGGGGGGGGGGGGGG               W
WWWWWWWWWWWWWWWWWWWWWWWWWWWWWWWWWWWWWWWWWWWWWWWWWWWWWWWWWWWW
